58,59,60,61,59,58,59,60,61,58,59,60,61,58,59,60,57,1,2,3,0,1,2,3,0,1,2,3,0,1,2,3,0,1,70,72,73,74,75,72,73,71,15,70,73,74,75,72,73,71
72,73,74,75,73,72,73,74,75,72,73,74,75,72,73,74,71,15,16,17,14,15,16,17,14,15,16,17,14,15,18,17,14,15,76,67,11,10,11,25,10,66,67,10,11,10,52,2,3,77
67,25,24,25,24,25,24,25,24,25,66,67,24,25,24,25,63,1,20,18,0,1,2,3,0,18,2,3,0,1,2,3,0,1,62,24,25,24,25,39,10,11,25,24,25,24,66,16,17,63
38,39,38,39,38,39,38,39,38,39,38,39,38,39,38,52,77,15,16,17,14,15,16,17,14,15,16,17,14,15,16,17,18,15,76,38,39,38,39,25,24,25,39,38,39,38,39,66,67,77
53,25,24,25,24,25,24,25,24,25,24,25,24,25,80,66,63,1,2,3,0,1,2,3,0,1,2,3,0,1,20,3,0,1,62,10,25,11,10,39,52,53,10,11,10,11,24,25,25,63
67,39,38,39,53,39,38,39,38,39,38,39,38,39,52,53,77,18,16,17,14,15,16,17,14,15,16,17,14,15,16,17,14,15,76,25,39,25,24,25,66,67,24,25,24,25,38,39,39,77
24,25,24,25,67,25,24,25,24,25,24,52,63,61,8,9,57,1,2,3,0,1,2,3,0,1,2,3,0,1,2,20,0,1,62,39,52,39,38,39,80,81,38,39,38,39,10,11,10,63
38,39,38,39,38,39,38,39,38,39,38,66,77,75,22,23,71,15,16,17,14,15,16,18,14,15,16,17,14,15,16,17,18,15,76,10,39,11,10,11,10,11,10,11,10,11,24,25,25,77
24,25,24,25,24,25,24,25,24,25,24,25,63,20,36,37,20,1,2,3,0,1,2,3,0,1,2,3,0,1,20,3,0,1,62,24,24,25,24,25,24,25,24,25,24,25,38,39,52,63
24,25,38,39,38,39,38,39,38,39,38,39,77,15,50,51,14,15,16,17,14,15,16,17,14,15,16,17,14,15,16,17,14,20,76,53,38,39,38,39,38,39,52,53,38,39,10,52,20,77
38,39,24,25,25,25,24,52,53,25,24,25,63,6,67,20,0,1,2,3,0,1,2,3,0,1,18,3,20,1,2,3,0,1,56,58,59,60,61,58,59,60,61,58,59,60,61,8,9,57
52,53,38,39,39,39,38,66,67,39,38,39,77,67,81,66,14,15,16,17,14,15,16,17,14,15,16,17,14,15,16,17,14,15,70,72,73,74,75,72,73,74,75,72,73,74,75,22,23,71
0,1,53,25,24,25,24,25,24,25,24,25,63,81,53,80,0,1,18,3,0,1,2,3,0,1,2,3,0,1,2,3,0,1,2,3,0,1,2,3,0,1,2,3,18,1,2,36,37,1
14,15,67,39,25,39,38,39,38,39,38,39,77,38,20,1,1,15,16,17,14,15,16,17,14,15,16,17,14,15,18,17,14,15,16,17,14,15,16,17,14,15,16,17,14,15,16,50,51,15
66,67,24,25,24,25,24,25,24,25,24,25,63,38,66,16,15,1,2,3,0,1,2,3,0,1,18,3,0,1,20,3,0,1,2,3,0,1,2,3,18,1,2,3,0,1,20,3,0,1
53,81,38,39,38,52,53,39,38,39,38,52,77,53,80,52,14,15,16,17,14,15,6,17,14,15,16,17,14,15,16,17,14,15,16,17,14,15,16,17,14,15,16,17,14,15,16,18,14,15
58,59,60,61,58,59,60,61,58,59,60,61,57,67,52,3,20,1,2,3,0,1,2,3,0,1,2,20,0,1,2,3,0,1,2,3,0,1,2,3,0,1,2,20,0,1,2,3,0,1
72,73,74,75,72,73,74,75,72,73,74,75,71,81,16,17,14,15,16,18,14,15,16,17,14,15,16,17,14,15,16,17,18,15,16,17,18,15,16,17,14,15,16,17,14,15,16,17,14,15
0,18,53,81,38,39,80,81,80,81,52,1,2,1,2,3,0,1,20,3,0,1,2,3,0,1,2,3,0,1,2,3,0,1,2,3,0,1,2,3,0,20,2,3,0,1,2,3,0,1
14,15,16,53,52,53,80,81,52,18,16,17,14,15,16,17,14,15,16,17,14,15,16,17,14,15,16,18,14,20,16,17,14,15,16,17,14,15,16,17,14,18,16,17,14,15,16,17,14,15
0,1,2,3,0,20,2,18,0,1,2,3,0,1,2,3,0,1,2,3,0,1,2,3,0,1,2,3,20,1,2,3,0,1,2,3,0,1,2,3,0,1,2,3,0,1,18,3,0,1
14,15,16,17,14,15,16,17,14,15,16,17,14,15,16,17,14,20,16,17,14,15,16,17,14,15,16,17,14,15,16,18,14,15,16,17,14,15,20,20,14,15,16,17,14,15,18,17,14,15
0,1,2,3,0,1,2,3,0,1,2,3,0,1,2,3,0,1,18,3,0,1,20,3,0,18,20,3,0,1,2,3,0,1,2,3,0,1,2,3,0,1,2,3,0,18,2,3,0,1
14,15,16,17,14,18,20,17,14,15,16,17,14,18,16,17,14,67,38,39,14,15,16,17,20,15,16,17,14,15,16,17,14,15,16,18,20,15,18,17,14,15,16,17,14,15,16,17,14,15
0,1,2,3,0,1,2,3,0,1,2,3,0,1,2,3,20,39,52,53,66,1,2,3,0,1,2,3,0,1,2,3,0,1,2,3,0,1,2,3,0,1,2,3,0,1,2,3,0,1
14,15,16,17,14,15,16,17,14,20,16,17,14,15,16,17,14,81,66,67,80,15,18,17,14,15,16,17,14,15,16,17,14,15,16,17,14,15,16,20,14,15,16,18,14,15,16,17,20,15
0,1,2,3,18,1,2,3,0,1,2,3,0,1,2,3,0,53,80,81,25,20,2,3,0,1,2,3,0,18,2,3,0,18,2,3,0,18,2,3,0,1,2,3,0,1,20,3,0,1
14,15,16,17,18,15,20,20,14,18,16,17,14,15,18,17,14,15,20,53,52,15,16,17,18,15,16,17,14,15,16,17,14,15,16,17,20,15,16,17,14,15,16,17,14,15,16,17,14,15
0,1,18,3,0,1,2,3,0,1,2,3,0,1,2,3,0,1,2,3,0,1,2,3,0,1,2,3,0,1,2,3,0,1,2,3,0,1,2,18,0,1,2,3,20,1,2,18,0,1
14,15,16,17,14,18,16,17,14,20,16,17,14,15,16,17,14,15,18,17,20,15,16,17,14,15,16,17,14,15,16,17,14,15,16,17,14,15,16,17,14,20,16,17,14,15,20,18,14,15
0,1,2,3,0,1,2,3,21,1,2,18,0,1,2,3,0,1,2,3,0,1,2,3,0,39,2,3,0,18,2,3,0,1,2,3,0,18,20,3,0,1,2,3,0,1,2,3,18,1
14,15,16,17,14,15,20,67,66,15,16,17,14,15,16,17,14,15,16,18,53,66,16,17,14,15,16,17,14,15,16,17,14,15,16,17,14,15,16,17,14,15,16,17,14,15,16,17,18,15
0,18,2,18,0,1,67,52,25,1,2,3,0,1,2,3,0,1,2,3,67,52,2,20,0,1,2,3,0,1,2,3,0,1,2,20,20,1,2,3,0,1,2,3,20,1,18,3,0,1
14,15,16,17,14,18,67,66,67,66,16,20,14,15,16,17,14,15,20,17,14,15,16,17,66,67,16,17,14,15,16,17,14,15,16,17,14,15,16,17,14,15,16,17,18,15,16,17,14,15
0,1,2,3,0,19,24,25,24,80,67,24,25,52,20,3,38,1,2,67,39,1,2,67,80,81,2,3,0,1,2,3,18,1,2,3,0,1,2,3,0,1,2,3,0,1,2,3,0,1
14,15,16,17,20,67,39,24,38,80,81,38,39,66,16,20,14,15,16,38,38,66,67,38,10,11,20,17,14,15,16,17,14,15,16,17,20,15,16,17,14,15,16,18,14,20,18,17,14,15
20,1,2,18,67,38,39,38,52,1,2,3,18,1,2,3,0,18,2,3,53,80,81,52,24,25,66,3,0,20,2,18,0,1,2,3,0,18,2,3,20,1,20,6,7,18,20,20,20,1
80,81,24,25,24,25,38,80,20,15,16,17,14,15,16,17,14,15,16,17,20,15,18,17,14,15,16,17,14,15,16,17,20,15,16,17,14,15,16,20,14,15,16,7,6,20,19,18,19,15
80,81,38,39,38,39,80,52,19,1,2,3,0,1,2,3,0,1,2,3,0,1,2,3,0,1,2,3,0,20,2,3,0,1,2,3,20,1,2,3,0,1,18,3,0,7,18,20,7,1
20,19,16,17,14,15,18,17,14,15,16,17,14,15,18,17,14,15,16,17,14,15,16,17,14,15,16,17,14,15,16,17,14,15,16,17,14,15,16,17,14,15,16,17,14,18,16,17,14,15
